Get Outta My Dreams, Get Into My Car :: Billy Ocean
Man In The Mirror :: Michael Jackson
Out Of The Blue :: Debbie Gibson
Devil Inside :: INXS
Where Do Broken Hearts Go :: Whitney Houston
Rocket 2 U :: The Jets
Endless Summer Nights :: Richard Marx
Girlfriend :: Pebbles
I Want Her :: Keith Sweat
Wishing Well :: Terence Trent D'Arby
I Saw Him Standing There :: Tiffany
Angel :: Aerosmith
Some Kind Of Lover :: Jody Watley
(Sittin' On) The Dock Of The Bay :: Michael Bolton
Check It Out :: John Mellencamp
Pink Cadillac :: Natalie Cole
Prove Your Love :: Taylor Dayne
Never Gonna Give You Up :: Rick Astley
One Step Up :: Bruce Springsteen
Anything For You :: Gloria Estefan & Miami Sound Machine
Hysteria :: Def Leppard
Electric Blue :: Icehouse
You Don't Know :: Scarlett & Black
I Get Weak :: Belinda Carlisle
Rock Of Life :: Rick Springfield
Father Figure :: George Michael
Fishnet :: Morris Day
Naughty Girls (Need Love Too) :: Samantha Fox
Always On My Mind :: Pet Shop Boys
She's Like The Wind :: Patrick Swayze (Featuring Wendy Fraser)
Going Back To Cali (From "Less Than Zero") :: LL Cool J
I Wish I Had A Girl :: Henry Lee Summer
Shattered Dreams :: Johnny Hates Jazz
Pamela :: Toto
Two Occasions :: The Deele
I Don't Want To Live Without You :: Foreigner
Wait :: White Lion
Piano In The Dark :: Brenda Russell Featuring Joe Esposito
Just Like Paradise :: David Lee Roth
Never Knew Love Like This :: Alexander O'Neal Featuring Cherrelle
Are You Sure :: So
Kiss And Tell (From "Bright Lights, Big City") :: Bryan Ferry
Dreaming :: Orchestral Manoeuvres In The Dark
Say It Again :: Jermaine Stewart
I Found Someone :: Cher
Strange But True :: Times Two
What A Wonderful World :: Louis Armstrong
One Good Reason :: Paul Carrack
My Girl :: Suave
Savin' Myself :: Eria Fachin
Yes (From The Motion Picture "Dirty Dancing") :: Merry Clayton
Ritual :: Dan Reed Network
Push It :: Salt-N-Pepa
Pump Up The Volume :: M/A/R/R/S
Love In The First Degree :: Bananarama
Hungry Eyes (From "Dirty Dancing") :: Eric Carmen
Nightime :: Pretty Poison
Can't Stay Away From You :: Gloria Estefan & Miami Sound Machine
When We Was Fab :: George Harrison
Be Still My Beating Heart :: Sting
Promise Me :: The Cover Girls
I Still Believe :: Brenda K. Starr
Play That Funky Music :: Roxanne
Give Me All Your Love :: Whitesnake
Hot Hot Hot!!! :: The Cure
Breakaway :: Big Pig
I'm Still Searching :: Glass Tiger
Talking Back To The Night :: Steve Winwood
Samantha (What You Gonna Do?) :: Cellarful Of Noise
I Want You So Bad :: Heart
Love Overboard :: Gladys Knight And The Pips
Beds Are Burning :: Midnight Oil
Don't Make A Fool Of Yourself :: Stacey Q
Don't Shed A Tear :: Paul Carrack
What Have I Done To Deserve This? :: Pet Shop Boys & Dusty Springfield
Never Thought (That I Could Love) :: Dan Hill
Kiss Me Deadly :: Lita Ford
Presence Of Love :: The Alarm
Need You Tonight :: INXS
Because Of You :: The Cover Girls
Get It On :: Kingdom Come
Save Your Love :: Great White
Century's End (From "Bright Lights, Big City") :: Donald Fagen
We All Sleep Alone :: Cher
Never Die Young :: James Taylor
Nite And Day :: Al B. Sure!
Take It While It's Hot :: Sweet Sensation
Say You Will :: Foreigner
Ever Since The World Began :: Tommy Shaw
Family Man :: Fleetwood Mac
Under The Milky Way :: The Church
The Flame :: Cheap Trick
Turn Off The Lights :: Lonzo And World Class Wreckin Kru
Like A Child :: Noel
I Want To Be Your Property :: Blue Mercedes
Ooo La La La :: Teena Marie
Seasons Change :: Expose
Magic Carpet Ride :: Bardeux
Jack The Lad :: 3 Man Island
Could've Been :: Tiffany
